report_date,pcr_neg,pcr_pos,pcr_int,pcr_total,pcr_avg
2020-03-16,409,30,0,439,NA
2020-03-17,635,50,0,685,NA
2020-03-18,741,57,2,800,NA
2020-03-19,1056,72,1,1129,NA
2020-03-20,1080,104,2,1186,NA
2020-03-21,742,83,2,827,NA
2020-03-22,630,79,0,709,825
2020-03-23,1633,178,3,1814,1021.4285714285714
2020-03-24,1855,214,0,2069,1219.142857142857
2020-03-25,2209,224,6,2439,1453.2857142857142
2020-03-26,2170,258,1,2429,1639
2020-03-27,1845,295,0,2140,1775.2857142857142
2020-03-28,1090,193,2,1285,1840.7142857142858
2020-03-29,752,140,0,892,1866.857142857143
2020-03-30,2410,360,0,2770,2003.4285714285713
2020-03-31,2170,297,1,2468,2060.4285714285716
2020-04-01,2025,273,2,2300,2040.5714285714287
2020-04-02,1889,290,4,2183,2005.4285714285713
2020-04-03,1732,250,2,1984,1983.142857142857
2020-04-04,954,145,2,1101,1956.857142857143
2020-04-05,785,112,3,900,1958
2020-04-06,2424,317,7,2748,1954.857142857143
2020-04-07,2082,241,2,2325,1934.4285714285713
2020-04-08,2063,253,1,2317,1936.857142857143
2020-04-09,1770,214,4,1988,1909
2020-04-10,1994,240,5,2239,1945.4285714285713
2020-04-11,854,105,1,960,1925.2857142857142
2020-04-12,694,99,3,796,1910.4285714285713
2020-04-13,1982,283,4,2269,1842
2020-04-14,1962,236,6,2204,1824.7142857142858
2020-04-15,1833,241,4,2078,1790.5714285714287
2020-04-16,1845,234,4,2083,1804.142857142857
2020-04-17,2173,202,4,2379,1824.142857142857
2020-04-18,1082,171,0,1253,1866
2020-04-19,831,150,2,983,1892.7142857142858
2020-04-20,2445,317,10,2772,1964.5714285714287
2020-04-21,2300,273,9,2582,2018.5714285714287
2020-04-22,2706,279,6,2991,2149
2020-04-23,2638,281,9,2928,2269.714285714286
2020-04-24,2472,266,17,2755,2323.4285714285716
2020-04-25,1174,140,1,1315,2332.285714285714
2020-04-26,1042,98,1,1141,2354.8571428571427
2020-04-27,3781,357,7,4145,2551
2020-04-28,4563,430,14,5007,2897.4285714285716
2020-04-29,4558,379,9,4946,3176.714285714286
2020-04-30,3850,332,11,4193,3357.4285714285716
2020-05-01,4222,335,13,4570,3616.714285714286
2020-05-02,1577,92,2,1671,3667.5714285714284
2020-05-03,1094,90,2,1186,3674
2020-05-04,3857,314,15,4186,3679.8571428571427
2020-05-05,4619,329,17,4965,3673.8571428571427
2020-05-06,4076,260,8,4344,3587.8571428571427
2020-05-07,3771,181,10,3962,3554.8571428571427
2020-05-08,4394,177,6,4577,3555.8571428571427
2020-05-09,2102,131,4,2237,3636.714285714286
2020-05-10,1255,76,0,1331,3657.4285714285716
2020-05-11,5058,262,11,5331,3821
2020-05-12,5257,234,7,5498,3897.1428571428573
2020-05-13,5342,341,9,5692,4089.714285714286
2020-05-14,4859,265,3,5127,4256.142857142857
2020-05-15,5691,255,13,5959,4453.571428571428
2020-05-16,3887,99,1,3987,4703.571428571428
2020-05-17,2769,125,2,2896,4927.142857142857
2020-05-18,6447,282,6,6735,5127.714285714285
2020-05-19,5787,298,6,6091,5212.428571428572
2020-05-20,5744,306,3,6053,5264
2020-05-21,5593,322,10,5925,5378
2020-05-22,6899,253,9,7161,5549.714285714285
2020-05-23,2989,110,2,3101,5423.142857142857
2020-05-24,2460,82,3,2545,5373
2020-05-25,2350,93,2,2445,4760.142857142857
2020-05-26,12660,364,13,13037,5752.428571428572
2020-05-27,11510,356,10,11876,6584.285714285715
2020-05-28,10208,269,7,10484,7235.571428571428
2020-05-29,9474,271,7,9752,7605.714285714285
2020-05-30,4333,323,4,4660,7828.428571428572
2020-05-31,2776,213,3,2992,7892.285714285715
2020-06-01,10151,348,82,10581,9054.57142857143
2020-06-02,8398,283,13,8694,8434.142857142857
2020-06-03,8773,278,10,9061,8032
2020-06-04,7635,310,17,7962,7671.714285714285
2020-06-05,8697,323,9,9029,7568.428571428572
2020-06-06,3318,123,3,3444,7394.714285714285
2020-06-07,2322,81,0,2403,7310.571428571428
2020-06-08,9497,369,8,9874,7209.571428571428
2020-06-09,10165,390,2,10557,7475.714285714285
2020-06-10,9899,385,11,10295,7652
2020-06-11,7929,346,7,8282,7697.714285714285
2020-06-12,8452,386,10,8848,7671.857142857143
2020-06-13,3823,172,6,4001,7751.428571428572
2020-06-14,2605,124,1,2730,7798.142857142857
2020-06-15,13852,521,45,14418,8447.285714285714
2020-06-16,11652,577,111,12340,8702
2020-06-17,9760,510,20,10290,8701.285714285714
2020-06-18,9498,658,41,10197,8974.857142857143
2020-06-19,10494,492,17,11003,9282.714285714286
2020-06-20,4483,259,11,4753,9390.142857142857
2020-06-21,2880,231,0,3111,9444.57142857143
2020-06-22,15394,720,93,16207,9700.142857142857
2020-06-23,11676,664,26,12366,9703.857142857143
2020-06-24,11000,746,29,11775,9916
2020-06-25,9429,655,16,10100,9902.142857142857
2020-06-26,11759,665,9,12433,10106.42857142857
2020-06-27,5496,412,3,5911,10271.857142857143
2020-06-28,4612,278,2,4892,10526.285714285714
2020-06-29,17500,989,32,18521,10856.857142857143
2020-06-30,14202,989,15,15206,11262.57142857143
2020-07-01,13456,1063,24,14543,11658
2020-07-02,12538,1077,14,13629,12162.142857142857
2020-07-03,8009,710,15,8734,11633.714285714286
2020-07-04,3622,358,6,3986,11358.714285714286
2020-07-05,4003,378,0,4381,11285.714285714286
2020-07-06,15972,1292,12,17276,11107.857142857143
2020-07-07,15704,1338,18,17060,11372.714285714286
2020-07-08,15288,1462,20,16770,11690.857142857143
2020-07-09,15120,1318,37,16475,12097.42857142857
2020-07-10,14853,1260,33,16146,13156.285714285714
2020-07-11,8620,717,28,9365,13924.714285714286
2020-07-12,5705,492,8,6205,14185.285714285714
2020-07-13,20600,1529,50,22179,14885.714285714286
2020-07-14,17806,1433,33,19272,15201.714285714286
2020-07-15,16057,1246,21,17324,15280.857142857143
2020-07-16,13342,1174,15,14531,15003.142857142857
2020-07-17,14322,1132,13,15467,14906.142857142857
2020-07-18,7471,743,13,8227,14743.57142857143
2020-07-19,4948,547,11,5506,14643.714285714286
2020-07-20,19704,1722,26,21452,14539.857142857143
2020-07-21,16130,1405,27,17562,14295.57142857143
2020-07-22,12972,1341,18,14331,13868
2020-07-23,13109,1326,30,14465,13858.57142857143
2020-07-24,13573,1208,22,14803,13763.714285714286
2020-07-25,7476,558,9,8043,13737.42857142857
2020-07-26,5285,428,10,5723,13768.42857142857
2020-07-27,16980,1379,37,18396,13331.857142857143
2020-07-28,16217,1138,21,17376,13305.285714285714
2020-07-29,11310,1129,13,12452,13036.857142857143
2020-07-30,10094,797,4,10895,12526.857142857143
2020-07-31,9889,426,2,10317,11886
2020-08-01,887290,62455,1623,951368,146646.7142857143
