report_date,pcr_neg,pcr_pos,pcr_int,pcr_total,pcr_avg
2020-03-16,409,30,0,439,NA
2020-03-17,635,50,0,685,NA
2020-03-18,737,56,2,795,NA
2020-03-19,1056,71,1,1128,NA
2020-03-20,1076,104,2,1182,NA
2020-03-21,741,82,2,825,NA
2020-03-22,626,79,0,705,822.7142857142857
2020-03-23,1628,176,4,1808,1018.2857142857143
2020-03-24,1850,214,0,2064,1215.2857142857142
2020-03-25,2205,224,6,2435,1449.5714285714287
2020-03-26,2166,258,1,2425,1634.857142857143
2020-03-27,1841,296,0,2137,1771.2857142857142
2020-03-28,1090,193,2,1285,1837
2020-03-29,747,139,0,886,1862.857142857143
2020-03-30,2407,361,0,2768,2000
2020-03-31,2167,301,1,2469,2057.8571428571427
2020-04-01,2020,274,2,2296,2038
2020-04-02,1886,292,3,2181,2003.142857142857
2020-04-03,1731,250,2,1983,1981.142857142857
2020-04-04,950,145,2,1097,1954.2857142857142
2020-04-05,784,113,3,900,1956.2857142857142
2020-04-06,2417,319,7,2743,1952.7142857142858
2020-04-07,2081,242,2,2325,1932.142857142857
2020-04-08,2060,252,1,2313,1934.5714285714287
2020-04-09,1766,214,4,1984,1906.4285714285713
2020-04-10,1986,241,5,2232,1942
2020-04-11,851,105,1,957,1922
2020-04-12,694,98,3,795,1907
2020-04-13,1977,282,4,2263,1838.4285714285713
2020-04-14,1959,235,6,2200,1820.5714285714287
2020-04-15,1831,241,4,2076,1786.7142857142858
2020-04-16,1840,234,4,2078,1800.142857142857
2020-04-17,2171,202,4,2377,1820.857142857143
2020-04-18,1080,172,0,1252,1863
2020-04-19,830,150,2,982,1889.7142857142858
2020-04-20,2443,315,10,2768,1961.857142857143
2020-04-21,2297,273,9,2579,2016
2020-04-22,2704,279,6,2989,2146.4285714285716
2020-04-23,2639,282,9,2930,2268.1428571428573
2020-04-24,2470,263,17,2750,2321.4285714285716
2020-04-25,1172,139,1,1312,2330
2020-04-26,1042,90,1,1133,2351.5714285714284
2020-04-27,3780,349,7,4136,2547
2020-04-28,4564,429,14,5007,2893.8571428571427
2020-04-29,4555,379,9,4943,3173
2020-04-30,3839,333,11,4183,3352
2020-05-01,4216,333,13,4562,3610.8571428571427
2020-05-02,1577,93,2,1672,3662.285714285714
2020-05-03,1089,89,2,1180,3669
2020-05-04,3856,298,14,4168,3673.5714285714284
2020-05-05,4618,325,17,4960,3666.8571428571427
2020-05-06,4075,257,8,4340,3580.714285714286
2020-05-07,3768,181,10,3959,3548.714285714286
2020-05-08,4390,177,6,4573,3550.285714285714
2020-05-09,2099,129,4,2232,3630.285714285714
2020-05-10,1253,76,0,1329,3651.5714285714284
2020-05-11,5054,260,11,5325,3816.8571428571427
2020-05-12,5257,232,7,5496,3893.4285714285716
2020-05-13,5340,339,9,5688,4086
2020-05-14,4860,264,3,5127,4252.857142857143
2020-05-15,5682,253,13,5948,4449.285714285715
2020-05-16,3882,99,2,3983,4699.428571428572
2020-05-17,2765,124,3,2892,4922.714285714285
2020-05-18,6441,281,6,6728,5123.142857142857
2020-05-19,5782,296,6,6084,5207.142857142857
2020-05-20,5743,306,3,6052,5259.142857142857
2020-05-21,5581,316,10,5907,5370.571428571428
2020-05-22,6892,250,9,7151,5542.428571428572
2020-05-23,2987,109,2,3098,5416
2020-05-24,2457,82,3,2542,5366
2020-05-25,2348,93,2,2443,4753.857142857143
2020-05-26,12653,362,13,13028,5745.857142857143
2020-05-27,11510,356,10,11876,6577.857142857143
2020-05-28,10205,270,7,10482,7231.428571428572
2020-05-29,9474,269,7,9750,7602.714285714285
2020-05-30,4329,323,4,4656,7825.285714285715
2020-05-31,2767,212,3,2982,7888.142857142857
2020-06-01,10081,349,81,10511,9040.714285714286
2020-06-02,8396,282,13,8691,8421.142857142857
2020-06-03,8770,278,10,9058,8018.571428571428
2020-06-04,7636,308,18,7962,7658.571428571428
2020-06-05,8691,322,9,9022,7554.571428571428
2020-06-06,3315,123,3,3441,7381
2020-06-07,2322,81,0,2403,7298.285714285715
2020-06-08,9488,368,8,9864,7205.857142857143
2020-06-09,10172,387,2,10561,7473
2020-06-10,9891,378,10,10279,7647.428571428572
2020-06-11,7934,347,7,8288,7694
2020-06-12,8449,389,10,8848,7669.142857142857
2020-06-13,3820,170,6,3996,7748.428571428572
2020-06-14,2601,124,1,2726,7794.571428571428
2020-06-15,13845,520,43,14408,8443.714285714286
2020-06-16,11649,576,112,12337,8697.42857142857
2020-06-17,9762,512,19,10293,8699.42857142857
2020-06-18,9489,664,41,10194,8971.714285714286
2020-06-19,10491,492,18,11001,9279.285714285714
2020-06-20,4480,258,11,4749,9386.857142857143
2020-06-21,2877,232,0,3109,9441.57142857143
2020-06-22,15398,718,92,16208,9698.714285714286
2020-06-23,11685,666,26,12377,9704.42857142857
2020-06-24,11000,744,29,11773,9915.857142857143
2020-06-25,9437,653,16,10106,9903.285714285714
2020-06-26,11764,666,10,12440,10108.857142857143
2020-06-27,5561,412,3,5976,10284.142857142857
2020-06-28,4619,278,2,4899,10539.857142857143
2020-06-29,17531,982,33,18546,10873.857142857143
2020-06-30,14232,986,16,15234,11282
2020-07-01,13493,1060,25,14578,11682.714285714286
2020-07-02,12567,1076,14,13657,12190
2020-07-03,8005,710,14,8729,11659.857142857143
2020-07-04,3627,359,6,3992,11376.42857142857
2020-07-05,4039,378,0,4417,11307.57142857143
2020-07-06,16022,1296,12,17330,11133.857142857143
2020-07-07,15801,1343,18,17162,11409.285714285714
2020-07-08,15336,1459,21,16816,11729
2020-07-09,15233,1323,39,16595,12148.714285714286
2020-07-10,14896,1259,36,16191,13214.714285714286
2020-07-11,8708,714,28,9450,13994.42857142857
2020-07-12,5791,492,7,6290,14262
2020-07-13,20697,1533,52,22282,14969.42857142857
2020-07-14,18046,1450,35,19531,15307.857142857143
2020-07-15,16304,1273,22,17599,15419.714285714286
2020-07-16,13608,1214,14,14836,15168.42857142857
2020-07-17,14607,1172,14,15793,15111.57142857143
2020-07-18,7536,757,15,8308,14948.42857142857
2020-07-19,5008,554,12,5574,14846.142857142857
2020-07-20,20174,1701,32,21907,14792.57142857143
2020-07-21,16672,1448,34,18154,14595.857142857143
2020-07-22,13606,1404,21,15031,14229
2020-07-23,14213,1397,34,15644,14344.42857142857
2020-07-24,14488,1317,23,15828,14349.42857142857
2020-07-25,7641,650,10,8301,14348.42857142857
2020-07-26,5397,493,15,5905,14395.714285714286
2020-07-27,18527,1540,40,20107,14138.57142857143
2020-07-28,17399,1323,30,18752,14224
2020-07-29,13569,1414,26,15009,14220.857142857143
2020-07-30,12396,1236,16,13648,13935.714285714286
2020-07-31,12899,1118,10,14027,13678.42857142857
2020-08-01,7219,608,20,7847,13613.57142857143
2020-08-02,5369,609,22,6000,13627.142857142857
2020-08-03,19729,1632,38,21399,13811.714285714286
2020-08-04,15860,1421,26,17307,13605.285714285714
2020-08-05,12976,1375,19,14370,13514
2020-08-06,12316,1132,13,13461,13487.285714285714
2020-08-07,13418,1146,19,14583,13566.714285714286
2020-08-08,6769,717,10,7496,13516.57142857143
2020-08-09,5184,491,7,5682,13471.142857142857
2020-08-10,17105,1459,23,18587,13069.42857142857
2020-08-11,13904,1260,23,15187,12766.57142857143
2020-08-12,10863,1388,33,12284,12468.57142857143
2020-08-13,10299,1014,9,11322,12163
2020-08-14,7455,717,9,8181,11248.42857142857
